NO textures/wall_1.xpm
SO textures/wall_2.xpm
EA textures/wall_3.xpm
WE textures/wall_4.xpm

F 199,45,91
C 41,117,119

1111111
1000001
1110111
1000001
10W0001
1000001
1111111
