NO textures/klown_&_wall_64.xpm
SO textures/torch/torch2_wall_2.xpm
SO textures/torch/torch3_wall_2.xpm
SO textures/torch/torch1_wall_2.xpm
WE textures/klown_&_wall_64.xpm
EA textures/torch/torch1_wall_3.xpm
EA textures/torch/torch2_wall_3.xpm
EA textures/torch/torch3_wall_3.xpm

C 169,177,180
F 124,31,19

11111111111111111111111111111
10000000001100000000000000001
10110000011100000000000010001
10010000000000000000000010001
10110000011100000000000010001
10000000001100000111011110001
11110111111111011100000010001
11110111111111011101010010001
11000000110101011100000010001
10000000000000001100000010001
10000000000000001100010000001
11000000110101000000000000001
1111c111110101000000000000001
10000000001100000100000010001
1000o00000o000000000000001001
1000N000001000010000000001001
10000000001101000000000000001
10000000000100000001010000001
11111111111111111111111111111
