NO textures/klown_&_wall_64.xpm
SO textures/torch/txt_torch_1.xpm
SO textures/torch/txt_torch_2.xpm
SO textures/torch/txt_torch_3.xpm
SO textures/torch/txt_torch_4.xpm
WE textures/txt_4.xpm
EA textures/wall_1.xpm
DOOR_CLOSED textures/clown_door.xpm
DOOR_OPEN textures/black.xpm

C 124,112,106
F 124,31,19

11111111111111111111111111111111111
10000000001100000000000000001000001
10110000011100000000000010000000001
10010000000000000000000011D11000001
10110000011100000000000010001111001
10000000001100000111011110001111001
1D110111111111011100000010001000001
10110111111111011101010010001100001
1100000011010101110000001000D000011
10000000000000001100000010001100001
10000000000000001100010000001000001
11000000110101000100000000011110001
1111D111110101000100000000001000001
10000000001100000100000010001000001
1000000000D000000D00000001001001001
1000N000001000010100000001001001001
10000000001101000100000000000001111
10000000000100000101010000001111111
11111111111111111111111111111111111
