NO textures/wall_1.xpm
SO textures/wall_2.xpm
WE textures/wall_3.xpm
EA textures/wall_3.xpm

F 184,113,39
C 51,198,227

11111111111111111111111111111
10000000001100000000000000001
10110000011100000001111011111
11111111110000000000000000011
10110000011100000000000111111
10000000001100000111111111111
11111111111111011100000010001
11110111111111011101010010001
11000000110101011100000010001
11110111000000001100000010001
10000000000000001100011111111
11110000110101000000000011111
11110111110101000000000000001
10000000001100000100N00010001
10000000000000000000000001001
10000000111100010000000001001
10000000001100110101110000001
10000000111110000000010100001
11111111111111111111111111111
